//MAP CONVERTED BY dmm2tgm.py THIS HEADER COMMENT PREVENTS RECONVERSION, DO NOT REMOVE
"a" = (
/turf/open/floor/carpet/stellar,
/area/rogue/outdoors/town)
"d" = (
/turf/open/floor/rogue/cobblerock,
/area/rogue/outdoors/town)
"f" = (
/obj/structure/closet/crate/chest/steward/wheat,
/turf/open/floor/carpet/stellar,
/area/rogue/outdoors/town)
"g" = (
/turf/open/floor/carpet/stellar,
/area/rogue/indoors/town/manor)
"h" = (
/obj/structure/fermenting_barrel/water,
/turf/open/floor/carpet/stellar,
/area/rogue/outdoors/town)
"i" = (
/obj/structure/table/church,
/obj/structure/stonebig{
	pixel_y = 32
	},
/turf/open/floor/carpet/stellar,
/area/rogue/outdoors/town)
"k" = (
/obj/structure/table/church{
	dir = 1
	},
/obj/item/reagent_containers/glass/bucket/pot{
	pixel_x = 0;
	pixel_y = 6
	},
/obj/structure/stonebig{
	pixel_y = 32
	},
/turf/open/floor/carpet/stellar,
/area/rogue/outdoors/town)
"l" = (
/turf/closed/wall/mineral/rogue/stonebrick/reddish,
/area/rogue/outdoors/town)
"q" = (
/obj/item/rogueore/coal,
/turf/open/floor/carpet/stellar,
/area/rogue/outdoors/town)
"r" = (
/obj/machinery/light/rogue/oven{
	pixel_x = -1;
	pixel_y = 31;
	plane = -4
	},
/obj/structure/stonebig{
	pixel_y = 32
	},
/turf/open/floor/carpet/stellar,
/area/rogue/outdoors/town)
"v" = (
/obj/effect/landmark/start/lord{
	dir = 8
	},
/obj/effect/landmark/latejoin,
/turf/open/floor/carpet/stellar,
/area/rogue/outdoors/town)
"A" = (
/obj/structure/announcementmicrophone,
/turf/open/floor/carpet/stellar,
/area/rogue/outdoors/town)
"D" = (
/obj/machinery/light/rogue/firebowl/church{
	pixel_x = 17;
	pixel_y = -2
	},
/turf/open/floor/carpet/stellar,
/area/rogue/outdoors/town)
"H" = (
/obj/item/key/steward,
/turf/open/floor/carpet/stellar,
/area/rogue/outdoors/town)
"I" = (
/obj/machinery/light/rogue/firebowl/church,
/turf/open/floor/carpet/stellar,
/area/rogue/outdoors/town)
"M" = (
/obj/structure/announcementspeaker,
/turf/open/floor/carpet/stellar,
/area/rogue/outdoors/town)
"N" = (
/obj/machinery/light/rogue/firebowl/church{
	pixel_x = 16;
	pixel_y = 24
	},
/turf/open/floor/carpet/stellar,
/area/rogue/outdoors/town)
"R" = (
/obj/machinery/light/rogue/oven{
	pixel_x = -1;
	pixel_y = 64;
	plane = -4
	},
/obj/structure/stonebig{
	pixel_y = 32
	},
/turf/open/floor/carpet/stellar,
/area/rogue/outdoors/town)
"S" = (
/turf/open/floor/carpet/stellar,
/area/rogue/indoors/town/church)
"T" = (
/obj/item/rogueore/coal,
/obj/item/rogueore/coal,
/obj/item/rogueore/coal,
/obj/item/rogueore/coal,
/obj/item/rogueore/coal,
/obj/item/rogueore/coal,
/obj/item/rogueore/coal,
/obj/item/rogueore/coal,
/turf/open/floor/carpet/stellar,
/area/rogue/outdoors/town)
"X" = (
/obj/structure/table/church/m,
/obj/structure/fluff/millstone{
	pixel_x = 0;
	pixel_y = 8
	},
/obj/structure/stonebig{
	pixel_y = 32
	},
/turf/open/floor/carpet/stellar,
/area/rogue/outdoors/town)

(1,1,1) = {"
d
d
d
d
d
d
d
d
d
d
d
d
d
d
d
d
d
d
d
d
d
d
d
d
d
d
d
d
d
d
d
d
"}
(2,1,1) = {"
d
a
a
a
a
a
a
a
a
a
a
a
a
a
a
a
a
a
a
a
a
a
a
a
a
a
a
a
a
a
a
d
"}
(3,1,1) = {"
d
a
a
a
a
a
a
a
a
a
a
a
a
a
a
a
a
a
a
a
a
a
a
a
a
a
a
a
a
a
a
d
"}
(4,1,1) = {"
d
a
a
a
a
a
a
a
a
a
a
a
a
a
a
a
a
a
a
a
a
a
a
a
a
a
a
a
a
a
a
d
"}
(5,1,1) = {"
d
a
a
a
a
a
a
a
a
a
a
a
a
a
a
a
a
a
a
a
a
a
a
a
a
a
a
a
a
a
a
d
"}
(6,1,1) = {"
d
a
a
a
a
a
a
a
a
S
S
S
S
S
a
g
g
g
g
g
a
a
a
a
a
a
a
a
a
a
a
d
"}
(7,1,1) = {"
d
a
a
a
a
a
a
a
a
S
S
S
S
S
a
g
g
g
g
g
a
a
a
a
a
a
a
a
a
a
a
d
"}
(8,1,1) = {"
d
a
a
a
a
a
a
a
a
S
S
S
S
S
a
g
g
g
g
g
a
a
a
a
a
a
a
a
a
a
a
d
"}
(9,1,1) = {"
d
a
a
a
a
a
a
a
a
S
S
S
S
S
a
g
g
g
g
g
a
a
a
a
a
a
a
a
a
a
a
d
"}
(10,1,1) = {"
d
a
a
a
a
a
a
a
a
S
S
S
S
S
a
g
g
g
g
g
a
a
a
a
a
a
a
a
a
a
a
d
"}
(11,1,1) = {"
d
a
a
a
a
a
a
a
a
a
a
a
a
a
a
a
a
a
a
a
a
a
a
a
a
a
a
a
a
a
a
d
"}
(12,1,1) = {"
d
a
a
a
a
a
a
a
a
a
a
a
f
H
a
a
a
a
a
a
a
a
a
a
a
a
a
a
a
a
a
d
"}
(13,1,1) = {"
d
a
a
a
a
a
a
a
a
a
a
N
f
a
a
a
a
a
a
a
a
a
a
a
a
a
a
a
a
a
a
d
"}
(14,1,1) = {"
d
a
a
a
a
a
a
a
a
a
a
a
f
q
a
a
a
a
a
a
a
a
a
a
a
a
a
a
a
a
a
d
"}
(15,1,1) = {"
d
a
a
a
a
a
I
a
M
a
a
l
R
T
I
a
I
a
a
a
a
a
a
a
a
a
a
a
a
a
a
d
"}
(16,1,1) = {"
d
a
a
a
a
a
a
a
a
a
a
l
r
a
a
v
a
a
a
a
a
a
a
a
a
a
a
a
a
a
a
d
"}
(17,1,1) = {"
d
a
a
a
a
a
M
a
A
a
M
l
i
a
I
a
I
a
a
a
a
a
a
a
a
a
a
a
a
a
a
d
"}
(18,1,1) = {"
d
a
a
a
a
a
a
a
a
a
a
a
X
a
a
a
a
a
a
a
a
a
a
a
a
a
a
a
a
a
a
d
"}
(19,1,1) = {"
d
a
a
a
a
a
a
a
M
a
D
a
k
a
a
a
a
a
a
a
a
a
a
a
a
a
a
a
a
a
a
d
"}
(20,1,1) = {"
d
a
a
a
a
a
a
a
a
a
a
a
a
h
a
a
a
a
a
a
a
a
a
a
a
a
a
a
a
a
a
d
"}
(21,1,1) = {"
d
a
a
a
a
a
a
a
a
a
a
a
a
a
a
a
a
a
a
a
a
a
a
a
a
a
a
a
a
a
a
d
"}
(22,1,1) = {"
d
a
a
a
a
a
a
a
a
a
a
a
a
a
a
a
a
a
a
a
a
a
a
a
a
a
a
a
a
a
a
d
"}
(23,1,1) = {"
d
a
a
a
a
a
a
a
a
a
a
a
a
a
a
a
a
a
a
a
a
a
a
a
a
a
a
a
a
a
a
d
"}
(24,1,1) = {"
d
a
a
a
a
a
a
a
a
a
a
a
a
a
a
a
a
a
a
a
a
a
a
a
a
a
a
a
a
a
a
d
"}
(25,1,1) = {"
d
a
a
a
a
a
a
a
a
a
a
a
a
a
a
a
a
a
a
a
a
a
a
a
a
a
a
a
a
a
a
d
"}
(26,1,1) = {"
d
a
a
a
a
a
a
a
a
a
a
a
a
a
a
a
a
a
a
a
a
a
a
a
a
a
a
a
a
a
a
d
"}
(27,1,1) = {"
d
a
a
a
a
a
a
a
a
a
a
a
a
a
a
a
a
a
a
a
a
a
a
a
a
a
a
a
a
a
a
d
"}
(28,1,1) = {"
d
a
a
a
a
a
a
a
a
a
a
a
a
a
a
a
a
a
a
a
a
a
a
a
a
a
a
a
a
a
a
d
"}
(29,1,1) = {"
d
a
a
a
a
a
a
a
a
a
a
a
a
a
a
a
a
a
a
a
a
a
a
a
a
a
a
a
a
a
a
d
"}
(30,1,1) = {"
d
a
a
a
a
a
a
a
a
a
a
a
a
a
a
a
a
a
a
a
a
a
a
a
a
a
a
a
a
a
a
d
"}
(31,1,1) = {"
d
a
a
a
a
a
a
a
a
a
a
a
a
a
a
a
a
a
a
a
a
a
a
a
a
a
a
a
a
a
a
d
"}
(32,1,1) = {"
d
d
d
d
d
d
d
d
d
d
d
d
d
d
d
d
d
d
d
d
d
d
d
d
d
d
d
d
d
d
d
d
"}
